11111
10P01
1C001
10E01
1C001
1C001
10101
1C001
1C001
10101
1C001
11111