111111
100001
1PC0E1
1000C01
100C01
100001
111111