111111
111P11
110001
1011C1
1001E1
111111