111111
100001
1PC0E1
1QWRC1
100C01
100001
111111